1111111
1P00001
101111
100C001
1010101
1000E01
1111111
