1111111
1P00001
1011111
1000001
1C010E1
100E0E1
1111111
