11111111
1P000001

10101101
1C000E01
11111111
