1111111
1P00001
1011111
1000001
1011111
100E001
1111111
