1111111111111111111111111111111111111111111111111111111111111
1P0000000000000000000000000000000000000000000000000000000E1
1111111111111111111111111111111111111111111111111111111111111
