111111
1P0C01
101101
100001
111111
