1111111
1P0C001
1 10111
1 00C01
1010101
1000E01
1111111
