1111111
1P0CCC1
1C11111
1C00001
1C010C1
1C00EC1
1111111
