1111111
1P11111
1111111
1C11111
1111E11
1111111
