1111111
1P00001
1011111
1000001
1110101
10000E1
1111111
