1111111
1P02001
1011111
1020001
1012101
1003E01
1111111
