1111111
1000C01
1000011
1C01101
1010E01
1111111
