1P0C01
10101
100001
101E01
111111
111111
111111
