1111111
1P00C01
10000E1
1C01101
1010E01
1111111
