111111
1P0C01
10 101
1000E1
111111
