1111111
1P00001
1011101
1000101
1010101
100C0E1
1111111
