1111111
1P00001
1010111
100C001
1010101
1000E01
1111111
