1111111
1P00001
1011101
1C00001
1010111
1000E01
1111111
