1111111
1P0C001
1010101
1000101
1C01111
1000E01
1111111
