11111111
1P000001
10111001
1000C001
10101101
1000E001
11111111
