11111111
1P000C01
10111101
10000001
10101101
1000E001
11111111
