1111111
1P0C001
1010101
1C00001
1011101
1000E01
1111111
