111111111
1P0000001
101111101
100C00001
101011101
100001E01
111111111
