111111
1P0C01
101101
100E01
111111
