1111111
1P00001
1011111
1000C01
1C01001
100E101
1111111
