11111111
1P000001
10111001
10000001
10101101
1C000E01
11111111
