1111111
1P0C001
1010111
1000C01
1010101
1000E01
1111111
