1111111
1P00001
1C01111
1000001
1010101
1000E01
1111111
