11111111
1P000001
10111001
10001001
1C010101
1000E001
11111111
